m...m...m...m...m...m...m...m...m...m...m...m...m...m...m...m...m...m.F.m...m...
......................................................................F.........
..........###########...........#.##.......##.............##..........F.........
.........#...................##...........###.........##......##......F.........
#####..#.#............#########....##########.##################################
