................................................................................
................................................................................
.....#.###......................................................................
...#............................................................................
##############..################################################################
